7:1115110111111011011111101101111300000001111011011111101101111110110111111000002111101101111110115111
6:1111111011111111100311111110111111111011111111101140000000001111111011200000000111111115111111111011
1:1111111111111111111120001100031110110111111011011140001100044000110004111000011111111111111111111111
5:0000001000011110111001000412000111011010014000111000111011100111131100001111111001010101005000040005
4:4000050004010100101101010010110101001011010100101321010010101101001010110100101011010010104000500004
3:0111011153000000000401110111104000000000011101111000000000040111011110400000000001110111102111000000
2:0502013505400010000400000100004000100004000001000040001000040000010000400010000400000100005050000050